01 01 01 01 01 01 01 01 01
02 02 02 02 02 02 02 02 02
03 01 03 01 01 01 01 01 01
00 00 00 00 00 00 00 00 00
00 00 00 00 00 00 00 00 00
00 00 00 00 00 00 00 00 00
00 00 00 00 00 00 00 00 00
00 00 00 00 00 00 00 00 00
00 00 00 00 00 00 00 00 00
00 00 00 00 00 00 00 00 00